111111111111111111111
101000001000000000001
101010101011111110001
100010100010000010001
111110101111101011101
100000101000101000001
101111101011101111111
101000001010100000101
101011111010111110101
101010001010100010101
101110101010101010101
111111101010001010001
111111101011111011101
100000101000100010001
101110101110101110111
101000100000100010101
101011111111111010101111111111111111111111
100010000000000010001111111111111111111101
100000000000000000001111111111111111111101
100000000N00000000000000011111111111111101
100000000000000000001100000000000000000001
100000000000000000000000011111111111111111
10000000000000000000111111
101000001000000000001
111111111111111111111
